Allergy & Immunology: ['Allergy & Immunology', 'Allergy and Immunology', 'Allergy/Immunology', 'Immunology']
Anatomy (Embryology): ['Anatomy (Embryology)', 'Anatomy/Embryology']
Behavioral Science / Medical Ethics: ['Behavioral Science / Medical Ethics', 'Behavioral Science / Medical Ethics (Physician–Patient Communication & Shared Decision-Making)', 'Medical Ethics']
Bioethics (Research Ethics): ['Bioethics (Research Ethics)']
Biostatistics & Epidemiology: ['Biostatistics & Epidemiology', 'Biostatistics / Epidemiology', 'Biostatistics/Epidemiology', 'Epidemiology & Biostatistics', 'Epidemiology/Biostatistics', 'Preventive Medicine (Epidemiology/Biostatistics)', 'Biostatistics (Public Health/Epidemiology)', 'Biostatistics / Epidemiology (Diagnostic test interpretation)', 'Biostatistics / Epidemiology (Diagnostic testing)', 'Biostatistics / Epidemiology (Preventive Medicine)', 'Biostatistics/Epidemiology (Preventive Medicine)']
Biostatistics / Preventive Medicine: ['Biostatistics / Preventive Medicine', 'Preventive Medicine']
Cardiology: ['Cardiology', 'Cardiology (Preventive Cardiology)']
Dermatology: ['Dermatology']
Emergency Medicine: ['Emergency Medicine', 'Emergency Medicine (Toxicology/Environmental Exposure)', 'Emergency Medicine (Trauma)', 'Medical Ethics (EMTALA)/Emergency Medicine']
Endocrinology: ['Endocrinology', 'Endocrinology (Lipid Disorders)', 'Endocrinology (Lipid Disorders/Metabolism)']
Family Medicine: ['Family Medicine']
Gastroenterology: ['Gastroenterology', 'Gastroenterology (Colorectal/Anorectal disorders)', 'Gastroenterology (Hepatobiliary)', 'Gastroenterology (Hepatobiliary/General Surgery)', 'Gastroenterology (Hepatology)', 'Gastroenterology (Hepatology/Portal Hypertension)', 'Gastroenterology / Hepatology', 'Gastroenterology/Hepatology']
General Surgery: ['General Surgery', 'General Surgery (Breast)', 'General Surgery (Trauma Surgery)', 'General Surgery (Trauma)', 'General Surgery (Trauma/Thoracic Surgery)', 'Surgery']
Genetics: ['Genetics', 'Medical Genetics']
Geriatrics: ['Geriatrics']
Hematology: ['Hematology', 'Hematology (Sickle Cell Disease)', 'Hematology/Immunology', 'Hematology/Oncology', 'Pediatric Hematology-Oncology']
Infectious Disease: ['Infectious Disease', 'Infectious Disease (HIV/AIDS)', 'Infectious Disease (HIV/Antiretroviral Therapy)', 'Infectious Disease (Sexually Transmitted Infections)']
Internal Medicine: ['Internal Medicine', 'Internal Medicine (Critical Care)', 'Internal Medicine (Critical Care/Sepsis)', 'Internal Medicine (Preventive Care)']
Medical Ethics (End-of-life & Palliative Care): ['Medical Ethics (End-of-life & Palliative Care)', 'Palliative Care', 'Medical Ethics (Palliative Care/End-of-life decision-making)', 'Medical Ethics / Palliative Care']
Medical Ethics / Health Policy: ['Medical Ethics (Health Policy / Resource Allocation)', 'Medical Ethics / Health Policy', 'Medical Ethics / Health Policy (EMTALA)', 'Medical Ethics / Health Law (Professionalism, HIPAA)', 'Public Health / Health Policy & Ethics', 'Medical Ethics / Professionalism', 'Medical Ethics / Professionalism (Health Law—HIPAA & Medical Records Release)', 'Medical Ethics/Professionalism']
Medical Ethics / Health Systems (EMTALA): ['Medical Ethics / Health Systems (EMTALA)']
Nephrology: ['Nephrology']
Neurology: ['Neurology', 'Neurology (Sleep Medicine)']
OB-GYN: ['OB-GYN', 'OB-GYN (Gynecologic Oncology)', 'OB-GYN (Obstetrics)', 'OB-GYN (Obstetrics) / Ethics', 'OB-GYN (Urogynecology/Pelvic Floor Disorders)', 'OB-GYN (Gynecology/Reproductive Endocrinology)', 'OB-GYN (Reproductive Endocrinology / Primary Amenorrhea)', 'OB-GYN (Reproductive Endocrinology/Disorders of Sex Development)', 'OB-GYN (Reproductive Endocrinology/Infertility)']
Obstetrics & Gynecology: ['Obstetrics & Gynecology', 'Obstetrics and Gynecology']
Oncology: ['Oncology', 'Otolaryngology (ENT) / Head & Neck Oncology', 'Oncology (Hematology/Oncology survivorship screening)']
Ophthalmology: ['Ophthalmology']
Orthopedic Surgery: ['Orthopedic Surgery']
Orthopedics: ['Orthopedics', 'Orthopedics (Musculoskeletal)', 'Orthopedics (Musculoskeletal/Primary care approach to low back pain)']
Otolaryngology (ENT): ['Otolaryngology (ENT)']
Palliative Care (End-of-life Medicine): ['Palliative Care (End-of-life Medicine)']
Pathology: ['Pathology']
Patient Safety & Quality Improvement: ['Patient Safety & Quality Improvement (Interprofessional Communication/Professionalism)']
Pediatrics: ['Pediatrics', 'Pediatrics (Neonatology)', 'Pediatrics (Neonatology/Pediatric Cardiology)', 'Pediatrics (Medical Genetics)', 'Pediatrics (Pediatric Hematology/Oncology & Pharmacology)', 'Pediatrics (Nephrology)', 'Pediatrics (Pediatric Nephrology)']
Pharmacology: ['Pharmacology', 'Pharmacology (Clinical Pharmacokinetics)']
Preventive Medicine: ['Preventive Medicine / Environmental & Occupational Health', 'Preventive Medicine (Biostatistics/Epidemiology)', 'Preventive Medicine (Medical Ethics / Research Ethics)', 'Preventive Medicine (Occupational & Environmental Health)', 'Preventive Medicine (Occupational Medicine)', 'Preventive Medicine / Occupational Medicine', 'Preventive Medicine (Patient Safety/Quality Improvement)', 'Preventive Medicine (Screening/Biostatistics)']
Preventive Medicine / Public Health: ['Preventive Medicine / Public Health (Environmental exposure)', 'Preventive Medicine / Public Health (Patient Safety & Quality Improvement)', 'Public Health (Patient Safety / Quality Improvement)']
Psychiatry: ['Psychiatry', 'Psychiatry (Addiction Medicine / Medical Ethics)', 'Psychiatry (Addiction Medicine)', 'Psychiatry (Behavioral Science)', 'Psychiatry (Behavioral Science/Ethics & Legal)', 'Psychiatry (Behavioral Science/Medical Ethics & Communication)', 'Psychiatry (Behavioral Science/Medical Ethics & Professionalism)', 'Psychiatry (Behavioral Science/Medical Ethics)', 'Psychiatry (Behavioral Science/Patient-Physician Communication)', 'Psychiatry (Behavioral Science/Physician-Patient Communication)', 'Psychiatry (Ethics/Legal)', 'Psychiatry (Ethics/Professionalism)', 'Psychiatry (Medical Ethics/Capacity)', 'Psychiatry (Medical Ethics/Decision-Making Capacity)', 'Psychiatry (Medical Ethics/Decision-making capacity)', 'Psychiatry (Sleep Medicine)', 'Psychiatry (Substance Use Disorders/Addiction Medicine)', 'Psychiatry (Substance Use/Intoxication; Psychopharmacology)']
Pulmonology: ['Pulmonology', 'Pulmonology / Critical Care', 'Pulmonology/Critical Care', 'Pulmonary/Critical Care Medicine']
Rheumatology: ['Rheumatology', 'Rheumatology (Systemic Vasculitis)']
Surgery (Trauma/Thoracic Surgery): ['Surgery (Trauma/Thoracic Surgery)']
Urology: ['Urology']
Vascular Surgery: ['Vascular Surgery']